*X*******X
*XXX*XXX*X
*****X***X
XXXXXX*XXX
***X*X*X*X
*X*X*X*X*X
*X***X***X
*XXXXXXX*X
*********X
XXXXXXXX**