***X*****X
XX*XXXXX*X
*X*X*****X
*X*X*XXX*X
***X***X*X
*XXX*X*XXX
*X***X***X
*XXXXXXX*X
*********X
XXXXXXXX**